

-1 -1 -1 -1 -1 -1 -1 -1 -1 -1 -1 -1 -1 -1 -1 -1 -1 -1 -1 -1 
-1 1 1 1 1 1 1 1 1 1 0 0 1 1 1 1 0 0 1 -1 
-1 2 0 1 0 0 0 0 0 1 1 1 0 0 0 0 1 0 1 -1 
-1 1 0 1 0 1 1 1 0 0 0 0 0 1 1 1 0 0 1 -1 
-1 1 0 1 0 1 0 1 0 1 1 1 1 0 0 0 0 1 0 -1 
-1 1 0 1 0 1 0 1 0 1 0 0 0 0 1 1 1 0 0 -1 
-1 1 0 0 0 1 0 0 0 1 0 1 1 1 0 0 0 0 0 -1 
-1 1 1 1 1 1 0 1 0 1 0 1 0 0 0 1 1 1 0 -1 
-1 0 0 0 0 0 0 1 0 1 0 0 1 0 1 0 0 1 0 -1 
-1 0 1 1 0 1 0 1 0 1 1 0 1 0 1 0 0 1 0 -1 
-1 0 1 0 1 0 0 1 0 0 0 0 1 0 0 0 1 0 0 -1 
-1 0 1 0 0 1 0 1 0 1 1 1 1 0 1 0 0 1 0 -1 
-1 1 1 1 0 1 0 0 0 1 0 0 0 0 1 1 0 1 1 -1 
-1 0 0 0 0 0 0 1 0 1 0 1 1 1 0 0 0 1 0 -1 
-1 0 1 1 1 1 0 1 0 0 0 1 0 0 0 1 0 0 1 -1 
-1 0 1 0 0 0 0 0 1 1 1 0 1 0 1 1 1 0 0 -1 
-1 0 0 1 1 1 0 0 0 1 0 0 1 0 0 0 0 1 0 -1 
-1 0 0 0 1 0 1 1 0 1 0 0 1 1 0 1 0 1 3 -1 
-1 1 0 1 1 0 0 1 0 0 1 0 0 0 0 1 0 1 1 -1 
-1 -1 -1 -1 -1 -1 -1 -1 -1 -1 -1 -1 -1 -1 -1 -1 -1 -1 -1 -1 

a exmple
-1 -1 -1 -1 -1 -1 -1 -1 -1 -1 -1 -1 -1 -1 -1 -1 -1 -1 -1 -1 
-1 0 0 0 0 0 0 0 0 0 0 0 0 0 0 0 0 0 0 -1 
-1 0 0 0 0 0 0 0 0 0 0 0 0 0 0 0 0 0 0 -1 
-1 0 0 0 0 0 0 0 0 0 0 0 0 0 0 0 0 0 0 -1 
-1 0 0 0 0 0 0 0 0 0 0 0 0 0 0 0 0 0 0 -1 
-1 0 0 0 0 0 0 0 0 0 0 0 0 0 0 0 0 0 0 -1 
-1 0 0 0 0 0 0 0 0 0 0 0 0 0 0 0 0 0 0 -1 
-1 0 0 0 0 0 0 0 0 0 0 0 0 0 0 0 0 0 0 -1 
-1 0 0 0 0 0 0 0 0 0 0 0 0 0 0 0 0 0 0 -1 
-1 0 0 0 0 0 0 0 0 0 0 0 0 0 0 0 0 0 0 -1 
-1 0 0 0 0 0 0 0 0 0 0 0 0 0 0 0 0 0 0 -1 
-1 0 0 0 0 0 0 0 0 0 0 0 0 0 0 0 0 0 0 -1 
-1 0 0 0 0 0 0 0 0 0 0 0 0 0 0 0 0 0 0 -1 
-1 0 0 0 0 0 0 0 0 0 0 0 0 0 0 0 0 0 0 -1 
-1 0 0 0 0 0 0 0 0 0 0 0 0 0 0 0 0 0 0 -1 
-1 0 0 0 0 0 0 0 0 0 0 0 0 0 0 0 0 0 0 -1 
-1 0 0 0 0 0 0 0 0 0 0 0 0 0 0 0 0 0 0 -1 
-1 0 0 0 0 0 0 0 0 0 0 0 0 0 0 0 0 0 0 -1 
-1 0 0 0 0 0 0 0 0 0 0 0 0 0 0 0 0 0 0 -1 
-1 -1 -1 -1 -1 -1 -1 -1 -1 -1 -1 -1 -1 -1 -1 -1 -1 -1 -1 -1 

a text example
-1 -1 -1 -1 -1 -1 -1 -1 -1 -1 -1 -1 -1 -1 -1 -1 -1 -1 -1 -1 
-1 0 0 0 0 0 0 0 0 0 0 0 0 0 0 0 0 0 0 -1 
-1 0 0 0 0 0 0 0 0 0 0 0 0 0 0 0 0 0 0 -1 
-1 0 0 0 0 0 0 0 0 0 0 0 0 0 0 0 0 0 0 -1 
-1 0 0 0 0 0 0 0 0 0 0 0 0 0 0 0 0 0 0 -1 
-1 0 0 0 0 0 0 0 0 0 0 0 0 0 0 0 0 0 0 -1 
-1 0 0 0 0 0 0 0 0 0 0 0 0 0 0 0 0 0 0 -1 
-1 0 0 0 0 0 0 0 0 0 0 0 0 0 0 0 0 0 0 -1 
-1 0 0 0 0 0 0 0 0 0 0 0 0 0 0 0 0 0 0 -1 
-1 0 0 0 0 0 0 0 0 0 0 0 0 0 0 0 0 0 0 -1 
-1 0 0 0 0 0 0 0 0 0 0 0 0 0 0 0 0 0 0 -1 
-1 0 0 0 0 0 0 0 0 0 0 0 0 0 0 0 0 0 0 -1 
-1 0 0 0 0 0 0 0 0 0 0 0 0 0 0 0 0 0 0 -1 
-1 0 0 0 0 0 0 0 0 0 0 0 0 0 0 0 0 0 0 -1 
-1 0 0 0 0 0 0 0 0 0 0 0 0 0 0 0 0 0 0 -1 
-1 0 0 0 0 0 0 0 0 0 0 0 0 0 0 0 0 0 0 -1 
-1 0 0 0 0 0 0 0 0 0 0 0 0 0 0 0 0 0 0 -1 
-1 0 0 0 0 0 0 0 0 0 0 0 0 0 0 0 0 0 0 -1 
-1 0 0 0 0 0 0 0 0 0 0 0 0 0 0 0 0 0 0 -1 
-1 -1 -1 -1 -1 -1 -1 -1 -1 -1 -1 -1 -1 -1 -1 -1 -1 -1 -1 -1 

123456
-1 -1 -1 -1 -1 -1 -1 -1 -1 -1 -1 -1 -1 -1 -1 -1 -1 -1 -1 -1 
-1 0 0 0 0 0 0 0 0 0 0 0 0 0 0 0 0 0 0 -1 
-1 0 0 0 0 0 0 0 0 0 0 0 0 0 0 0 0 0 0 -1 
-1 0 0 0 0 0 0 0 0 0 0 0 0 0 0 0 0 0 0 -1 
-1 0 0 0 0 0 0 0 0 0 0 0 0 0 0 0 0 0 0 -1 
-1 0 0 0 0 0 0 0 0 0 0 0 0 0 0 0 0 0 0 -1 
-1 0 0 0 0 0 0 0 0 0 0 0 0 0 0 0 0 0 0 -1 
-1 0 0 0 0 0 0 0 0 0 0 0 0 0 0 0 0 0 0 -1 
-1 0 0 0 0 0 0 0 0 0 0 0 0 0 0 0 0 0 0 -1 
-1 0 0 0 0 0 0 0 0 0 0 0 0 0 0 0 0 0 0 -1 
-1 0 0 0 0 0 0 0 0 0 0 0 0 0 0 0 0 0 0 -1 
-1 0 0 0 0 0 0 0 0 0 0 0 0 0 0 0 0 0 0 -1 
-1 0 0 0 0 0 0 0 0 0 0 0 0 0 0 0 0 0 0 -1 
-1 0 0 0 0 0 0 0 0 0 0 0 0 0 0 0 0 0 0 -1 
-1 0 0 0 0 0 0 0 0 0 0 0 0 0 0 0 0 0 0 -1 
-1 0 0 0 0 0 0 0 0 0 0 0 0 0 0 0 0 0 0 -1 
-1 0 0 0 0 0 0 0 0 0 0 0 0 0 0 0 0 0 0 -1 
-1 0 0 0 0 0 0 0 0 0 0 0 0 0 0 0 0 0 0 -1 
-1 0 0 0 0 0 0 0 0 0 0 0 0 0 0 0 0 0 0 -1 
-1 -1 -1 -1 -1 -1 -1 -1 -1 -1 -1 -1 -1 -1 -1 -1 -1 -1 -1 -1 

an intersting example
-1 -1 -1 -1 -1 -1 -1 -1 -1 -1 -1 -1 -1 -1 -1 -1 -1 -1 -1 -1 
-1 1 1 1 1 0 0 0 0 0 0 0 0 0 0 0 0 0 0 -1 
-1 2 0 0 1 0 0 0 0 0 0 0 0 0 0 0 0 0 0 -1 
-1 0 0 0 1 0 0 0 0 0 0 0 0 0 0 0 0 0 0 -1 
-1 1 1 0 1 0 0 0 0 0 0 0 0 0 0 0 0 0 0 -1 
-1 0 1 0 1 1 1 1 1 1 1 0 0 0 0 0 0 0 0 -1 
-1 0 1 0 0 0 0 0 0 0 1 0 0 0 0 0 0 0 0 -1 
-1 0 1 0 0 0 0 0 0 0 1 0 0 0 0 0 0 0 0 -1 
-1 0 1 1 1 1 1 0 0 0 1 0 0 0 0 0 0 0 0 -1 
-1 0 0 0 0 0 1 0 0 0 1 1 1 1 0 0 0 0 0 -1 
-1 0 0 0 0 0 1 0 0 0 0 0 0 1 0 0 0 0 0 -1 
-1 0 0 0 0 0 1 0 0 0 0 0 0 1 0 0 0 0 0 -1 
-1 0 0 0 0 0 1 1 1 1 1 0 0 1 1 1 0 0 0 -1 
-1 0 0 0 0 0 0 0 0 0 1 0 0 0 0 1 0 0 0 -1 
-1 0 0 0 0 0 0 0 0 0 1 0 0 0 0 1 0 0 0 -1 
-1 0 0 0 0 0 0 0 0 0 1 1 1 0 0 1 1 1 1 -1 
-1 0 0 0 0 0 0 0 0 0 0 0 1 0 0 0 0 0 0 -1 
-1 0 0 0 0 0 0 0 0 0 0 0 1 0 0 0 0 0 3 -1 
-1 0 0 0 0 0 0 0 0 0 0 0 1 1 1 1 1 1 1 -1 
-1 -1 -1 -1 -1 -1 -1 -1 -1 -1 -1 -1 -1 -1 -1 -1 -1 -1 -1 -1 
