
example one
-1 -1 -1 -1 -1 -1 -1 -1 -1 -1 -1 -1 -1 -1 -1 -1 -1 -1 -1 -1 
-1 0 1 0 0 0 0 0 0 0 0 0 0 0 0 0 0 0 0 -1 
-1 2 0 1 0 0 0 0 0 0 0 0 0 0 0 0 0 0 0 -1 
-1 0 1 0 1 0 0 0 0 0 0 0 0 0 0 0 0 0 0 -1 
-1 0 0 1 0 1 0 0 0 0 0 0 0 0 0 0 0 0 0 -1 
-1 0 0 0 1 0 1 0 0 0 0 0 0 0 0 0 0 0 0 -1 
-1 0 0 0 0 1 0 0 0 0 0 0 0 0 0 0 0 0 0 -1 
-1 0 0 0 0 0 0 0 0 0 0 0 0 0 0 0 0 0 0 -1 
-1 0 0 0 0 0 0 0 0 0 0 0 0 0 0 0 0 0 0 -1 
-1 0 0 0 0 0 0 0 0 0 0 0 0 0 0 0 0 0 0 -1 
-1 0 0 0 0 0 0 0 0 0 0 0 0 0 0 0 0 0 0 -1 
-1 0 0 0 0 0 0 0 0 0 0 0 0 0 0 0 0 0 0 -1 
-1 0 0 0 0 0 0 0 0 0 0 0 0 0 0 0 0 0 0 -1 
-1 0 0 0 0 0 0 0 0 0 0 0 0 0 0 0 0 0 0 -1 
-1 0 0 0 0 0 0 0 0 0 0 0 0 0 0 0 0 0 0 -1 
-1 0 0 0 0 0 0 0 0 0 0 0 0 0 0 0 0 0 0 -1 
-1 0 0 0 0 0 0 0 0 0 0 0 0 0 0 0 0 0 0 -1 
-1 0 0 0 0 0 0 0 0 0 0 0 0 0 0 0 0 0 3 -1 
-1 0 0 0 0 0 0 0 0 0 0 0 0 0 0 0 0 0 0 -1 
-1 -1 -1 -1 -1 -1 -1 -1 -1 -1 -1 -1 -1 -1 -1 -1 -1 -1 -1 -1 

no name
-1 -1 -1 -1 -1 -1 -1 -1 -1 -1 -1 -1 -1 -1 -1 -1 -1 -1 -1 -1 
-1 1 0 0 0 0 0 0 0 0 0 0 0 0 0 0 0 0 1 -1 
-1 2 1 0 0 0 0 0 0 0 0 0 0 0 0 0 0 1 0 -1 
-1 0 0 1 0 0 0 0 0 0 0 0 0 0 0 0 1 0 0 -1 
-1 0 0 0 1 0 0 0 0 0 0 0 0 0 0 1 0 0 0 -1 
-1 0 0 0 0 1 0 0 0 0 0 0 0 0 1 0 0 0 0 -1 
-1 0 0 0 0 0 1 0 0 0 0 0 0 1 0 0 0 0 0 -1 
-1 0 0 0 0 0 0 1 0 0 0 0 1 0 0 0 0 0 0 -1 
-1 0 0 0 0 0 0 0 1 0 0 1 0 0 0 0 0 0 0 -1 
-1 0 0 0 0 0 0 0 0 1 0 0 0 0 0 0 0 0 0 -1 
-1 0 0 0 0 0 0 0 0 0 1 0 0 0 0 0 0 0 0 -1 
-1 0 0 0 0 0 0 0 1 0 0 1 0 0 0 0 0 0 0 -1 
-1 0 0 0 0 0 0 1 0 0 0 0 1 0 0 0 0 0 0 -1 
-1 0 0 0 0 0 1 0 0 0 0 0 0 1 0 0 0 0 0 -1 
-1 0 0 0 0 1 0 0 0 0 0 0 0 0 1 0 0 0 0 -1 
-1 0 0 0 1 0 0 0 0 0 0 0 0 0 0 1 0 0 0 -1 
-1 0 0 1 0 0 0 0 0 0 0 0 0 0 0 0 1 0 0 -1 
-1 0 1 0 0 0 0 0 0 0 0 0 0 0 0 0 0 1 3 -1 
-1 1 0 0 0 0 0 0 0 0 0 0 0 0 0 0 0 0 1 -1 
-1 -1 -1 -1 -1 -1 -1 -1 -1 -1 -1 -1 -1 -1 -1 -1 -1 -1 -1 -1 

test
-1 -1 -1 -1 -1 -1 -1 -1 -1 -1 -1 -1 -1 -1 -1 -1 -1 -1 -1 -1 
-1 0 0 0 0 0 0 0 0 0 0 0 0 0 0 0 0 0 0 -1 
-1 2 0 0 0 0 0 0 0 0 0 0 0 0 0 0 0 0 0 -1 
-1 0 0 0 0 0 0 0 0 0 0 0 0 0 0 0 0 0 0 -1 
-1 0 0 0 0 0 0 0 0 0 0 0 0 0 0 0 0 0 0 -1 
-1 0 0 0 0 0 0 0 0 0 0 0 0 0 0 0 0 0 0 -1 
-1 0 0 0 0 0 0 0 0 0 0 0 0 0 0 0 0 0 0 -1 
-1 1 1 1 1 1 0 0 0 0 0 0 0 0 0 0 0 0 0 -1 
-1 0 0 0 0 0 0 0 0 0 0 0 0 0 0 0 0 0 0 -1 
-1 0 0 0 0 0 0 0 0 0 0 0 0 0 0 0 0 0 0 -1 
-1 0 0 0 0 0 0 0 0 0 0 0 0 0 0 0 0 0 0 -1 
-1 0 0 0 0 0 0 0 0 0 0 0 0 0 0 0 0 0 0 -1 
-1 0 0 0 0 0 0 0 0 0 0 0 0 0 0 0 0 0 0 -1 
-1 0 0 0 0 0 0 0 0 0 0 0 0 0 0 0 0 0 0 -1 
-1 0 0 0 0 0 0 0 0 0 0 0 0 0 0 0 0 0 0 -1 
-1 0 0 0 0 0 0 0 0 0 0 0 0 0 0 0 0 0 0 -1 
-1 0 0 0 0 0 0 0 0 0 0 0 0 0 0 0 0 0 0 -1 
-1 0 0 0 0 0 0 0 0 0 0 0 0 0 0 0 0 0 3 -1 
-1 0 0 0 0 0 0 0 0 0 0 0 0 0 0 0 0 0 0 -1 
-1 -1 -1 -1 -1 -1 -1 -1 -1 -1 -1 -1 -1 -1 -1 -1 -1 -1 -1 -1 
